[1]
\x01\x01\x01\x01\x02\x03\x04\x05\x06\x07\x08\x09\x0a\x0b\x0c\x02\x01\x01\x01\x01\x00\x00\x00\x00\x00\x00\x00\x00\x00\x00\x00\x00
\x0d\x0e\x0e\x0e\x0f\x10\x11\x12\x13\x14\x15\x16\x17\x18\x19\x02\x1a\x0e\x0e\x0d\x00\x00\x00\x00\x00\x00\x00\x00\x00\x00\x00\x00
\x1b\x00\x00\x00\x1c\x1d\x1d\x1d\x1d\x1d\x1d\x1d\x1d\x1d\x1d\x1e\x1f\x00\x00\x20\x00\x00\x00\x00\x00\x00\x00\x00\x00\x00\x00\x00
\x20\x00\x00\x00\x00\x00\x00\x00\x00\x00\x00\x00\x00\x2a\x7f\x29\x00\x00\x00\x20\x00\x00\x00\x00\x00\x00\x00\x00\x00\x00\x00\x00
\x20\x00\x00\x00\x00\x00\xed\x00\x00\x00\x00\x00\x00\x00\x00\x00\xed\x00\x00\x20\x00\x00\x00\x00\x00\x00\x00\x00\x00\x00\x00\x00
\x20\x00\x00\x00\x00\x00\xed\x00\x00\x00\x00\x00\x00\x00\x00\x00\xed\x00\x00\x20\x00\x00\x00\x00\x00\x00\x00\x00\x00\x00\x00\x00
\x20\x00\x00\x00\x00\x00\xed\x00\x00\x00\x00\x00\x00\x00\x00\x00\xed\x00\x00\x20\x00\x00\x00\x00\x00\x00\x00\x00\x00\x00\x00\x00
\x25\x00\x00\x26\x27\x27\x27\x27\x27\x27\x27\x27\x27\x27\x27\x27\x27\x27\x27\x28\x00\x00\x00\x00\x00\x00\x00\x00\x00\x00\x00\x00
\x20\x00\x00\x00\x00\x00\x00\x00\x00\x00\x00\x00\x00\x2a\x7f\x29\x00\x00\x00\x20\x00\x00\x00\x00\x00\x00\x00\x00\x00\x00\x00\x00
\x20\x00\x00\x00\x00\x00\xed\x00\x00\x00\x00\x00\x00\x00\x00\x00\xed\x00\x00\x20\x00\x00\x00\x00\x00\x00\x00\x00\x00\x00\x00\x00
\x20\x00\x00\x00\x00\x00\xed\x00\x00\x00\x00\x00\x00\x00\x00\x00\xed\x00\x00\x20\x00\x00\x00\x00\x00\x00\x00\x00\x00\x00\x00\x00
\x20\x00\x00\x00\x00\x00\xed\x00\x00\x00\x00\x00\x00\x00\x00\x00\xed\x00\x00\x20\x00\x00\x00\x00\x00\x00\x00\x00\x00\x00\x00\x00
\x25\x00\x00\x26\x27\x27\x27\x27\x27\x27\x27\x27\x27\x27\x27\x27\x27\x27\x27\x28\x00\x00\x00\x00\x00\x00\x00\x00\x00\x00\x00\x00
\x20\x00\x00\x00\x00\x00\x00\x00\x00\x00\x00\x00\x00\x2a\x7f\x29\x00\x00\x00\x20\x00\x00\x00\x00\x00\x00\x00\x00\x00\x00\x00\x00
\x20\x00\x00\x00\x00\x00\xed\x00\x00\x00\x00\x00\x00\x00\x00\x00\xed\x00\x00\x20\x00\x00\x00\x00\x00\x00\x00\x00\x00\x00\x00\x00
\x20\x00\x00\x00\x00\x00\xed\x00\x00\x00\x00\x00\x00\x00\x00\x00\xed\x00\x00\x20\x00\x00\x00\x00\x00\x00\x00\x00\x00\x00\x00\x00
\x20\x00\x00\x00\x00\x00\xed\x00\x00\x00\x00\x00\x00\x00\x00\x00\xed\x00\x00\x20\x00\x00\x00\x00\x00\x00\x00\x00\x00\x00\x00\x00
\x0d\x0e\x0e\x0e\x0e\x0e\x0e\x0e\x0e\x0e\x0e\x0e\x0e\x0e\x0e\x0e\x0e\x0e\x0e\x0d\x00\x00\x00\x00\x00\x00\x00\x00\x00\x00\x00\x00