[1|E]
\x01\x01\x01\x01\x01\x01\x01\x01\x01\x01\xd4\xd9\xd8\xd8\xd8\xd8\xd8\xd8\xd9\xd5\x00\x00\x00\x00\x00\x00\x00\x00\x00\x00\x00\x00
\x01\xee\xf4\xf4\xf4\xf4\xf4\xf4\xee\x01\xdd\x00\x00\x00\x00\x00\x00\x00\x00\xdf\x00\x00\x00\x00\x00\x00\x00\x00\x00\x00\x00\x00
\x01\xf7\x01\x02\x03\x04\x05\x06\xf7\x01\xdc\x00\x00\x00\x00\x00\x00\x00\x00\xde\x00\x00\x00\x00\x00\x00\x00\x00\x00\x00\x00\x00
\x01\xee\xf4\xf4\xf4\xf4\xf4\xf4\xee\x01\xdc\x00\x00\x00\x00\x00\x00\x00\x00\xde\x00\x00\x00\x00\x00\x00\x00\x00\x00\x00\x00\x00
\x01\x01\x01\x01\x01\x01\x01\x01\x01\x01\xdc\x00\x00\x00\x00\x00\x00\x00\x00\xde\x00\x00\x00\x00\x00\x00\x00\x00\x00\x00\x00\x00
\x01\x01\x01\x01\x01\x01\x01\x01\x01\x01\xdc\x00\x00\x00\x00\x00\x00\x00\x00\xde\x00\x00\x00\x00\x00\x00\x00\x00\x00\x00\x00\x00
\x01\x01\x01\x01\x01\x01\x01\x01\x01\x01\xdc\x00\x00\x00\x00\x00\x00\x00\x00\xde\x00\x00\x00\x00\x00\x00\x00\x00\x00\x00\x00\x00
\xee\xf4\xf4\xf4\xf4\xee\x01\x01\x01\x01\xdc\x00\x00\x00\x00\x00\x00\x00\x00\xde\x00\x00\x00\x00\x00\x00\x00\x00\x00\x00\x00\x00
\xf7\x00\x00\x00\x00\xf7\x01\x01\x01\x01\xdc\x00\x00\x00\x00\x00\x00\x00\x00\xde\x00\x00\x00\x00\x00\x00\x00\x00\x00\x00\x00\x00
\xf7\x00\x00\x00\x00\xf7\xd4\xd8\xd8\xd5\xdc\x00\x00\x00\x00\x00\x00\x00\x00\xde\x00\x00\x00\x00\x00\x00\x00\x00\x00\x00\x00\x00
\xf7\x00\x00\x00\x00\xf7\xdc\x00\x00\xde\xdc\x00\x00\x00\x00\x00\x00\x00\x00\xde\x00\x00\x00\x00\x00\x00\x00\x00\x00\x00\x00\x00
\xf7\x00\x00\x00\x00\xf7\xdc\x00\x00\xde\xdd\x00\x00\x00\x00\x00\x00\x00\x00\xdf\x00\x00\x00\x00\x00\x00\x00\x00\x00\x00\x00\x00
\xee\xf4\xf4\xf4\xf4\xee\xd6\xda\xda\xd7\xd6\xdb\xda\xda\xda\xda\xda\xda\xdb\xd7\x00\x00\x00\x00\x00\x00\x00\x00\x00\x00\x00\x00
\xd4\xd8\xd8\xd8\xd8\xd8\xd9\xd8\xd8\xd8\xd8\xd8\xd8\xd9\xd8\xd8\xd8\xd8\xd8\xd5\x00\x00\x00\x00\x00\x00\x00\x00\x00\x00\x00\x00
\xdc\x00\x00\x00\x00\x00\x00\x00\x00\x00\x00\x00\x00\x00\x00\x00\x00\x00\x00\xde\x00\x00\x00\x00\x00\x00\x00\x00\x00\x00\x00\x00
\xdd\x00\x00\x00\x00\x00\x00\x00\x00\x00\x00\x00\x00\x00\x00\x00\x00\x00\x00\xdf\x00\x00\x00\x00\x00\x00\x00\x00\x00\x00\x00\x00
\xdc\x00\x00\x00\x00\x00\x00\x00\x00\x00\x00\x00\x00\x00\x00\x00\x00\x00\x00\xde\x00\x00\x00\x00\x00\x00\x00\x00\x00\x00\x00\x00
\xd6\xda\xda\xda\xda\xda\xdb\xda\xda\xda\xda\xda\xda\xdb\xda\xda\xda\xda\xda\xd7\x00\x00\x00\x00\x00\x00\x00\x00\x00\x00\x00\x00