[1]
\xed\xed\x16\x17\x18\x19\x1a\x1b\x1c\x15\x15\xed\x05\x06\x07\x08\x09\x0a\xed\xed\x00\x00\x00\x00\x00\x00\x00\x00\x00\x00\x00\x00
\xee\xf4\x1d\x1e\x1f\x20\x21\x22\x23\x10\x11\xf4\x0b\x0c\x0d\x0e\x0f\xf4\xf4\xee\x00\x00\x00\x00\x00\x00\x00\x00\x00\x00\x00\x00
\xf7\x00\x00\x00\x00\x00\x00\x00\x00\x00\xfa\x00\x00\x00\x00\x00\x00\x00\x00\xf7\x00\x00\x00\x00\x00\x00\x00\x00\x00\x00\x00\x00
\xf7\x00\x00\x00\x00\x00\x00\x00\x00\x00\x12\xfb\xfb\xfb\xfb\xfb\xfb\xfb\xfb\xef\x00\x00\x00\x00\x00\x00\x00\x00\x00\x00\x00\x00
\xf7\x00\x00\x00\x00\x00\x00\x00\x00\x00\xfa\x24\x25\x26\xed\x00\x00\x00\x00\xf7\x00\x00\x00\x00\x00\x00\x00\x00\x00\x00\x00\x00
\xf7\x00\x00\x00\x00\x00\x00\x00\x00\x00\xfa\x00\x00\x00\x00\x00\x00\x00\x00\xf7\x00\x00\x00\x00\x00\x00\x00\x00\x00\x00\x00\x00
\xf7\x00\x00\x00\x00\x00\x00\x00\x00\x00\xfa\x27\x28\x29\x2a\x2b\x2c\x2d\x00\xf7\x00\x00\x00\x00\x00\x00\x00\x00\x00\x00\x00\x00
\xf7\x00\x00\x00\x00\x00\x00\x00\x00\x00\xfa\x00\x00\x00\x00\x00\x00\x00\x00\xf7\x00\x00\x00\x00\x00\x00\x00\x00\x00\x00\x00\x00
\xf7\x00\x00\x00\x00\x00\x00\x00\x00\x00\xfa\x00\x00\x00\x00\x00\x00\x00\x00\xf7\x00\x00\x00\x00\x00\x00\x00\x00\x00\x00\x00\x00
\xf7\x00\x00\x00\x40\x00\x00\x00\x00\x00\xfa\x2e\x2f\x30\x31\x32\xed\x00\x00\xf7\x00\x00\x00\x00\x00\x00\x00\x00\x00\x00\x00\x00
\xf7\x00\x00\x00\x00\x00\x00\x00\x00\x00\x13\xfb\xfb\xfb\xfb\xfb\xfb\xfb\xfb\xef\x00\x00\x00\x00\x00\x00\x00\x00\x00\x00\x00\x00
\xf7\x00\x00\x00\x40\x00\x00\xed\x00\x00\x00\x00\x00\x00\x00\x00\x00\x00\x00\xf7\x00\x00\x00\x00\x00\x00\x00\x00\x00\x00\x00\x00
\xee\xf4\xf4\xf4\xf4\xf4\xf4\xf4\xf4\xf4\xf4\xf4\xf4\xf4\xf4\xf4\xf4\xf4\xf4\xee\x00\x00\x00\x00\x00\x00\x00\x00\x00\x00\x00\x00
\xd4\xd8\xd8\xd8\xd8\xd8\xd9\xd8\xd8\xd8\xd8\xd8\xd8\xd9\xd8\xd8\xd8\xd8\xd8\xd5\x00\x00\x00\x00\x00\x00\x00\x00\x00\x00\x00\x00
\xdc\x00\x00\x00\x00\x00\x00\x00\x00\x00\x00\x00\x00\x00\x00\x00\x00\x00\x00\xde\x00\x00\x00\x00\x00\x00\x00\x00\x00\x00\x00\x00
\xdd\x00\x00\x00\x00\x00\x00\x00\x00\x00\x00\x00\x00\x00\x00\x00\x00\x00\x00\xdf\x00\x00\x00\x00\x00\x00\x00\x00\x00\x00\x00\x00
\xdc\x00\x00\x00\x00\x00\x00\x00\x00\x00\x00\x00\x00\x00\x00\x00\x00\x00\x00\xde\x00\x00\x00\x00\x00\x00\x00\x00\x00\x00\x00\x00
\xd6\xda\xda\xda\xda\xda\xdb\xda\xda\xda\xda\xda\xda\xdb\xda\xda\xda\xda\xda\xd7\x00\x00\x00\x00\x00\x00\x00\x00\x00\x00\x00\x00