[1]
\xed\xed\x14\x14\x4e\x4f\x50\x51\x52\x53\x54\xed\xed\xed\xed\xed\xed\xed\xed\xed\x00\x00\x00\x00\x00\x00\x00\x00\x00\x00\x00\x00
\xee\xf4\x10\x10\x55\x56\x57\x58\x59\x5a\x5b\xf4\xf4\xf4\xf4\xf4\xf4\xf4\xf4\xee\x00\x00\x00\x00\x00\x00\x00\x00\x00\x00\x00\x00
\xf7\x00\x00\x00\x00\x00\x00\x00\x00\x00\xfa\x00\x00\x00\x00\x00\x00\x00\x00\xf7\x00\x00\x00\x00\x00\x00\x00\x00\x00\x00\x00\x00
\xf7\x00\x00\x00\x00\x00\x00\x00\x00\x00\xfa\x00\x00\x00\x00\x00\x00\x00\x00\xf7\x00\x00\x00\x00\x00\x00\x00\x00\x00\x00\x00\x00
\xee\xf4\xf4\xf4\xf4\xf4\xf4\xf4\xf4\xf5\xf6\xfb\xfb\xfb\xfb\xfb\xfb\xfb\xfb\xef\x00\x00\x00\x00\x00\x00\x00\x00\x00\x00\x00\x00
\xed\xed\xed\xed\xed\xed\xed\xed\xed\xf7\x00\x00\x00\x00\x00\x00\x00\x00\x00\xf7\x00\x00\x00\x00\x00\x00\x00\x00\x00\x00\x00\x00
\xed\xed\xed\xed\xed\xed\xed\xed\xed\xf7\x00\x00\x00\x00\x00\x00\x00\x00\x00\xf7\x00\x00\x00\x00\x00\x00\x00\x00\x00\x00\x00\x00
\xed\xed\xed\xed\xed\xed\xed\xed\xed\xf7\x00\x00\x00\x00\x00\x00\x00\x00\x00\xf7\x00\x00\x00\x00\x00\x00\x00\x00\x00\x00\x00\x00
\xed\xed\xed\xed\xed\xed\xed\xed\xed\xf7\x00\x00\x00\x00\x00\x00\x00\x00\x00\xf7\x00\x00\x00\x00\x00\x00\x00\x00\x00\x00\x00\x00
\xed\xed\xed\xed\xed\xed\xed\xed\xed\xf7\x00\x00\x00\x00\x00\x00\x00\x00\x00\xf7\x00\x00\x00\x00\x00\x00\x00\x00\x00\x00\x00\x00
\xed\xed\xed\xed\xed\xed\xed\xed\xed\xf7\x00\x00\x00\x00\x00\x00\x00\x00\x00\xf7\x00\x00\x00\x00\x00\x00\x00\x00\x00\x00\x00\x00
\xed\xed\xed\xed\xed\xed\xed\xed\xed\xf7\x00\x00\x00\x00\x00\x00\x00\x00\x00\xf7\x00\x00\x00\x00\x00\x00\x00\x00\x00\x00\x00\x00
\xed\xed\xed\xed\xed\xed\xed\xed\xed\xf7\x00\x00\x00\x00\x00\x00\x00\x00\x00\xf7\x00\x00\x00\x00\x00\x00\x00\x00\x00\x00\x00\x00
\xed\xed\xed\xed\xed\xed\xed\xed\xed\xf7\x00\x00\x00\x00\x00\x00\x00\x00\x00\xf7\x00\x00\x00\x00\x00\x00\x00\x00\x00\x00\x00\x00
\xee\xf4\xf4\xf4\xf4\xf4\xf4\xf4\xf4\xf8\x00\x00\x00\x00\x00\x00\x00\x00\x00\xf7\x00\x00\x00\x00\x00\x00\x00\x00\x00\x00\x00\x00
\xf7\x00\x00\x00\x00\x00\x00\x00\x00\xfa\x00\x00\x00\x00\x00\x00\x00\x00\x00\xf7\x00\x00\x00\x00\x00\x00\x00\x00\x00\x00\x00\x00
\x41\x00\x00\x00\x00\x00\x00\x00\x00\x66\x00\x00\x00\x00\x00\x00\x00\x00\x00\xf7\x00\x00\x00\x00\x00\x00\x00\x00\x00\x00\x00\x00
\xee\xf4\xf4\xf4\xf4\xf4\xf4\xf4\xf4\xf0\xf4\xf4\xf4\xf4\xf4\xf4\xf4\xf4\xf4\xee\x00\x00\x00\x00\x00\x00\x00\x00\x00\x00\x00\x00