[1]
\xee\xf4\xf4\xf4\xf4\xf4\xf4\xf4\xf4\xf4\xf0\xf4\xf4\xf4\xf4\xf4\xf4\xf4\xf4\xee\x00\x00\x00\x00\x00\x00\x00\x00\x00\x00\x00\x00
\xf7\x00\x00\x00\x00\x00\x00\x00\x00\x00\xfa\x3c\x01\x00\x00\x00\x00\x00\xec\xf7\x00\x00\x00\x00\x00\x00\x00\x00\x00\x00\x00\x00
\xf7\x00\x84\x02\x2e\x14\x44\x5e\x00\x00\xf8\xf4\xf4\xf4\xf4\xf4\xf4\xf4\xf4\xee\x00\x00\x00\x00\x00\x00\x00\x00\x00\x00\x00\x00
\xf7\x00\x00\x00\x00\x00\x00\x00\x00\x00\xf7\x02\x03\x04\x04\x04\x04\x04\x03\x02\x00\x00\x00\x00\x00\x00\x00\x00\x00\x00\x00\x00
\xf7\x00\x05\x62\x59\x95\x44\x00\x00\x00\xf7\x02\x03\x04\x04\x04\x04\x04\x03\x02\x00\x00\x00\x00\x00\x00\x00\x00\x00\x00\x00\x00
\xf7\x00\x00\x00\x00\x00\x00\x00\x00\x00\xf7\x06\x07\x07\x07\x07\x07\x07\x07\x08\x00\x00\x00\x00\x00\x00\x00\x00\x00\x00\x00\x00
\xf7\x00\x45\x49\x58\x39\x62\x09\x3f\x00\xf7\x0a\x56\x57\x58\x59\x5a\x5b\x5c\x0b\x00\x00\x00\x00\x00\x00\x00\x00\x00\x00\x00\x00
\xf7\x00\x00\x00\x00\x00\x00\x00\x00\x00\xf7\x0a\x5d\x5e\x5f\x60\x61\x62\x63\x0b\x00\x00\x00\x00\x00\x00\x00\x00\x00\x00\x00\x00
\xf7\x00\x5a\x58\x5e\x00\x00\x00\x00\x00\xf7\x0a\x64\x65\x66\x67\x68\x69\x6a\x0b\x00\x00\x00\x00\x00\x00\x00\x00\x00\x00\x00\x00
\xf7\x00\x00\x00\x00\x00\x00\x00\x00\x00\xf7\x0a\x6b\x6c\x6d\x6e\x6f\x70\x71\x0b\x00\x00\x00\x00\x00\x00\x00\x00\x00\x00\x00\x00
\xf7\x00\x00\x00\x00\x00\x00\x00\x00\x00\xf7\x0a\x72\x73\x74\x75\x76\x77\x78\x0b\x00\x00\x00\x00\x00\x00\x00\x00\x00\x00\x00\x00
\xf7\x00\x00\x00\x00\x00\x00\x00\x00\x00\xf7\x0a\x79\x7a\x7b\x7c\x7d\x7e\x7f\x0b\x00\x00\x00\x00\x00\x00\x00\x00\x00\x00\x00\x00
\xee\xf4\xf4\xf4\xf4\xf4\xf4\xf4\xf4\xf4\xee\x0c\x0d\x0d\x0d\x0d\x0d\x0d\x0d\x0e\x00\x00\x00\x00\x00\x00\x00\x00\x00\x00\x00\x00
\xd4\xd8\xd8\xd8\xd8\xd8\xd9\xd8\xd8\xd8\xd8\xd8\xd8\xd9\xd8\xd8\xd8\xd8\xd8\xd5\x00\x00\x00\x00\x00\x00\x00\x00\x00\x00\x00\x00
\xdc\x00\x00\x00\x00\x00\x00\x00\x00\x00\x00\x00\x00\x00\x00\x00\x00\x00\x00\xde\x00\x00\x00\x00\x00\x00\x00\x00\x00\x00\x00\x00
\xdd\x00\x00\x00\x00\x00\x00\x00\x00\x00\x00\x00\x00\x00\x00\x00\x00\x00\x00\xdf\x00\x00\x00\x00\x00\x00\x00\x00\x00\x00\x00\x00
\xdc\x00\x00\x00\x00\x00\x00\x00\x00\x00\x00\x00\x00\x00\x00\x00\x00\x00\x00\xde\x00\x00\x00\x00\x00\x00\x00\x00\x00\x00\x00\x00
\xd6\xda\xda\xda\xda\xda\xdb\xda\xda\xda\xda\xda\xda\xdb\xda\xda\xda\xda\xda\xd7\x00\x00\x00\x00\x00\x00\x00\x00\x00\x00\x00\x00