[1]
\x01\x00\x00\x00\x00\x00\x00\x00\x00\x00\x02\x03\x03\x03\x03\x03\x03\x03\x03\x04\x00\x00\x00\x00\x00\x00\x00\x00\x00\x00\x00\x00
\x01\x00\x00\x00\x00\x00\x00\x00\x00\x00\x05\x00\x00\x00\x00\x00\x00\x00\x00\x06\x00\x00\x00\x00\x00\x00\x00\x00\x00\x00\x00\x00
\x01\x00\x00\x00\x00\x00\x00\x00\x00\x00\x07\x08\x08\x08\x08\x08\x08\x08\x08\x09\x00\x00\x00\x00\x00\x00\x00\x00\x00\x00\x00\x00
\x01\x0a\x0b\x0b\x0b\x0b\x0b\x0b\x0b\x0c\x00\x12\x13\x14\x15\x16\x17\x18\x19\x00\x00\x00\x00\x00\x00\x00\x00\x00\x00\x00\x00\x00
\x01\x0d\x0e\x0e\x0e\x0e\x0e\x0e\x0e\x0f\x00\x1a\x1b\x1c\x1d\x1e\x1f\x20\x00\x00\x00\x00\x00\x00\x00\x00\x00\x00\x00\x00\x00\x00
\x01\x00\x00\x00\x00\x00\x00\x00\x00\x00\x00\x22\x00\x23\x24\x25\x26\x27\x00\x00\x00\x00\x00\x00\x00\x00\x00\x00\x00\x00\x00\x00
\x01\x00\x00\x00\x00\x00\x00\x00\x00\x00\x00\x00\x00\x00\x21\x00\x00\x00\x00\x00\x00\x00\x00\x00\x00\x00\x00\x00\x00\x00\x00\x00
\x01\x00\x00\x00\x00\x00\x00\x00\x00\x00\x00\x00\x00\x00\x00\x00\x00\x00\x00\x00\x00\x00\x00\x00\x00\x00\x00\x00\x00\x00\x00\x00
\x01\x00\x28\x29\x2a\x2b\x2c\x2d\x2e\x2f\x30\x00\x31\x32\x33\x34\x35\x36\x37\x00\x00\x00\x00\x00\x00\x00\x00\x00\x00\x00\x00\x00
\x01\x00\x00\x00\x00\x00\x00\x00\x00\x00\x00\x00\x00\x00\x00\x00\x00\x00\x00\x00\x00\x00\x00\x00\x00\x00\x00\x00\x00\x00\x00\x00
\x01\x00\x00\x00\x00\x00\x00\x00\x00\x00\x00\x00\x00\x00\x00\x00\x00\x00\x00\x00\x00\x00\x00\x00\x00\x00\x00\x00\x00\x00\x00\x00
\x01\x00\x00\x00\x00\x00\x00\x00\x00\x00\x00\x00\x00\x00\x00\x00\x00\x00\x00\x00\x00\x00\x00\x00\x00\x00\x00\x00\x00\x00\x00\x00
\x01\x00\x00\x00\x00\x00\x00\x00\x00\x00\x00\x00\x00\x00\x00\x00\x00\x00\x00\x00\x00\x00\x00\x00\x00\x00\x00\x00\x00\x00\x00\x00
\x01\x00\x00\x00\x00\x00\x00\x00\x00\x00\x00\x00\x00\x00\x00\x00\x00\x00\x00\x00\x00\x00\x00\x00\x00\x00\x00\x00\x00\x00\x00\x00
\x01\x00\x00\x00\x00\x00\x00\x00\x00\x00\x00\x00\x00\x00\x00\x00\x00\x00\x00\x00\x00\x00\x00\x00\x00\x00\x00\x00\x00\x00\x00\x00
\x01\x00\x00\x00\x00\x00\x00\x00\x00\x00\x00\x00\x00\x00\x00\x00\x00\x00\x00\x00\x00\x00\x00\x00\x00\x00\x00\x00\x00\x00\x00\x00
\x01\x00\x00\x00\x00\x00\x00\x00\x00\x00\x00\x00\x00\x00\x00\x00\x00\x00\x00\x00\x00\x00\x00\x00\x00\x00\x00\x00\x00\x00\x00\x00
\x38\x39\x39\x39\x39\x39\x39\x39\x39\x39\x39\x39\x39\x39\x39\x39\x39\x39\x39\x39\x00\x00\x00\x00\x00\x00\x00\x00\x00\x00\x00\x00