[1|12]
\x3b\x3c\x3c\x3c\x3c\x3c\x3c\x3c\x3c\x3c\x3d\x00\x00\x00\x00\x00\x00\x00\x00\x00\x00\x00\x00\x00\x00\x00\x00\x00\x00\x00\x00\x00
\x3e\x00\x00\x00\x00\x00\x00\x00\x00\x00\x3f\x40\x27\x28\x29\x2a\x00\x00\x00\x00\x00\x00\x00\x00\x00\x00\x00\x00\x00\x00\x00\x00
\x3e\x00\x00\x00\x00\x00\x00\x00\x00\x00\x41\x42\x43\x43\x43\x43\x43\x43\x43\x43\x00\x00\x00\x00\x00\x00\x00\x00\x00\x00\x00\x00
\x3e\x00\x00\x00\x00\x00\x00\x00\x00\x00\x3f\x40\x2b\x2c\x2d\x2e\x00\x00\x00\x00\x00\x00\x00\x00\x00\x00\x00\x00\x00\x00\x00\x00
\x3e\x00\x00\x00\x00\x00\x00\x00\x00\x00\x41\x42\x43\x43\x43\x43\x43\x43\x43\x43\x00\x00\x00\x00\x00\x00\x00\x00\x00\x00\x00\x00
\x3e\x00\x00\x00\x00\x00\x00\x00\x00\x00\x3f\x40\x2f\x30\x31\x32\x00\x00\x00\x00\x00\x00\x00\x00\x00\x00\x00\x00\x00\x00\x00\x00
\x3e\x00\x00\x00\x00\x00\x00\x00\x00\x00\x41\x42\x43\x43\x43\x43\x43\x43\x43\x43\x00\x00\x00\x00\x00\x00\x00\x00\x00\x00\x00\x00
\x3e\x00\x00\x00\x00\x00\x00\x00\x00\x00\x3f\x40\x33\x34\x35\x36\x37\x00\x00\x00\x00\x00\x00\x00\x00\x00\x00\x00\x00\x00\x00\x00
\x3e\x00\x00\x00\x00\x00\x00\x00\x00\x00\x41\x42\x43\x43\x43\x43\x43\x43\x43\x43\x00\x00\x00\x00\x00\x00\x00\x00\x00\x00\x00\x00
\x3e\x00\x00\x22\x00\x00\x00\x00\x00\x00\x3f\x40\x38\x39\x3a\x00\x00\x00\x00\x00\x00\x00\x00\x00\x00\x00\x00\x00\x00\x00\x00\x00
\x3e\x00\x00\x00\x00\x00\x00\x00\x00\x00\x41\x42\x43\x43\x43\x43\x43\x43\x43\x43\x00\x00\x00\x00\x00\x00\x00\x00\x00\x00\x00\x00
\x3e\x00\x00\x22\x00\x00\x00\x00\x00\x00\x3f\x40\x3b\x3c\x3d\x3e\x00\x00\x00\x00\x00\x00\x00\x00\x00\x00\x00\x00\x00\x00\x00\x00
\x44\x45\x45\x45\x45\x45\x45\x45\x45\x45\x46\x42\x43\x43\x43\x43\x43\x43\x43\x43\x00\x00\x00\x00\x00\x00\x00\x00\x00\x00\x00\x00
\x00\x00\x00\x00\x00\x00\x00\x00\x00\x00\x00\x00\x00\x00\x00\x00\x00\x00\x00\x00\x00\x00\x00\x00\x00\x00\x00\x00\x00\x00\x00\x00
\x00\x00\x00\x00\x00\x00\x00\x00\x00\x00\x00\x00\x00\x00\x00\x00\x00\x00\x00\x00\x00\x00\x00\x00\x00\x00\x00\x00\x00\x00\x00\x00
\x00\x00\x00\x00\x00\x00\x00\x00\x00\x00\x00\x00\x00\x00\x00\x00\x00\x00\x00\x00\x00\x00\x00\x00\x00\x00\x00\x00\x00\x00\x00\x00
\x00\x00\x00\x00\x00\x00\x00\x00\x00\x00\x00\x00\x00\x00\x00\x00\x00\x00\x00\x00\x00\x00\x00\x00\x00\x00\x00\x00\x00\x00\x00\x00
\x00\x00\x00\x00\x00\x00\x00\x00\x00\x00\x00\x00\x00\x00\x00\x00\x00\x00\x00\x00\x00\x00\x00\x00\x00\x00\x00\x00\x00\x00\x00\x00